111111111111111111111111111111111111111111111111111111111111111
100000000000000020000000000000000000122222222222222222222222221
100002000111000000000000020000000000100000000000000000000000001
101100011111100000000000000000000000100000000000000000000000011
100000000002000011111000000000100000100000000000000000000000111
100000000000000000000000000000100000100000000000000000000001111
100000002000011100000000000000100000100000000000000000000011111
100000000000000000000000220000122222100000000000000000000111111
100011111110000000000000000000111111100000000000000000001111111
100000000000000000000000000000000000000000000000000000000000221
100000000000001111000000000000000000000000000000000000000000221
100000000000000000000000000000222222200000000000000000000000221
111111111111111111111111111111111111111111111111111111111111111

enemy x:5000 y:300 hp:12 v:20 max:1200
enemy x:1600 y:700 hp:1 v:20 max:200
enemy x:700 y:600 hp:2 v:10 max:300
enemy x:1900 y:200 hp:2 v:10 max:100
enemy x:1000 y:100 hp:2 v:10 max:100
checkpoint x:100 y:1100 id:1
checkpoint x:5900 y:900 id:2
checkpoint x:5600 y:200 id:3
checkpoint x:1600 y:500 id:4
checkpoint x:2400 y:200 id:5
checkpoint x:800 y:200 id:6
checkpoint x:1500 y:900 id:7
checkpoint x:400 y:700 id:8
player x:100 y:1200 hp:3 blocks:10