00000000
00000000
00000000
00000000
02000000
11111111