1111111111111111
1000000000000001
1000000000044401
1001440000000001
1000000000000001
1100300000000001
1001140000000001
1000000001100001
1000000030000301
1000011100000001
1200000000000301
1111111111111111