1111111111111111
1000000000000001
1000000500014401
1001410000000001
1000000000050001
1100300000000001
1001410000000001
1000000001100001
1000000030000301
1000011100000001
1200000004050301
1111111111111111