11111111
10000001
10000001
10000001
12000001
11111111